107
8
23 0 0 0 0 0 0 0 0 0 0 0 0 0 0 0 0 0 0 0 0 0 0 0 0 0 0 0 0 0 0 0 0 0 0 0 0 0 0 0 0 0 0 3 22 22 22 22 22 22 22 22 22 22 22 22 22 22 22 22 22 22 22 22 0 0 0 0 0 0 0 0 0 0 0 0 0 0 0 0 0 0 0 0 0 0 0 0 0 0 3 22 22 22 22 22 22 22 22 22 22 22 22 22 22 22 22
23 0 0 0 0 0 0 0 0 0 0 0 0 0 0 0 0 0 0 0 0 0 0 0 0 0 0 0 0 0 0 0 0 0 0 0 0 0 0 0 0 0 0 0 18 22 22 22 22 22 22 22 22 22 22 22 22 22 22 22 19 17 17 17 0 0 0 0 0 0 0 0 0 0 0 0 0 0 0 0 0 0 0 0 0 0 0 0 0 0 0 18 22 22 22 22 22 19 17 17 17 17 17 17 17 18 22
23 0 0 0 0 0 0 0 0 0 0 0 0 0 0 0 0 0 14 0 0 0 0 0 0 0 0 0 0 0 0 0 0 0 0 0 0 0 0 0 10 0 0 0 0 17 17 17 18 22 22 22 22 22 22 22 22 22 22 22 4 0 0 16 0 0 0 0 0 0 0 0 0 0 0 0 0 0 0 0 0 0 0 0 0 0 0 0 0 0 0 0 18 22 22 22 22 4 0 0 0 0 0 0 0 3 22
23 0 0 0 0 0 0 0 0 0 0 0 0 0 0 0 0 0 0 0 0 0 0 0 0 0 0 0 0 0 0 0 0 0 11 0 0 0 0 23 24 25 0 0 0 0 0 0 0 17 17 18 22 22 22 22 22 22 22 19 0 0 10 0 11 0 0 0 0 0 0 0 0 0 0 0 0 0 0 9 0 0 0 0 1 20 2 0 0 0 0 0 0 18 22 22 22 4 0 0 0 0 0 0 0 3 22
23 0 0 0 0 0 0 0 0 0 0 0 0 0 20 20 2 0 0 0 0 0 0 0 0 0 0 15 0 0 0 0 0 23 25 0 0 0 0 0 0 0 0 0 0 9 11 0 0 0 0 0 17 17 17 17 17 17 17 0 0 1 20 20 20 2 0 0 0 0 0 0 0 0 0 0 0 0 0 23 24 25 0 0 3 22 4 0 0 0 0 0 0 0 18 22 22 4 0 0 0 0 0 0 0 3 22
23 0 0 0 0 0 0 0 0 0 0 20 20 20 6 22 4 0 0 20 20 20 10 9 0 0 0 0 0 0 10 0 0 0 0 0 0 11 0 0 0 0 0 1 20 20 20 20 2 0 0 0 9 0 0 0 0 9 0 0 0 3 22 22 22 4 0 0 0 0 0 0 0 0 0 0 0 0 0 0 0 0 0 0 3 22 4 0 0 0 0 0 0 0 0 17 17 0 0 0 0 0 0 0 0 3 22
23 0 0 0 0 0 0 0 0 0 0 22 22 22 22 22 4 0 0 0 1 20 20 20 20 2 0 0 9 1 20 20 2 0 9 1 20 20 2 0 0 0 0 3 22 22 22 22 4 10 0 1 20 2 0 0 1 20 2 11 1 20 6 0 0 0 0 0 0 0 0 0 0 0 0 0 10 9 0 0 11 0 0 1 20 5 20 2 0 0 0 0 0 0 0 0 0 0 0 10 11 0 0 9 0 3 22
26 20 20 20 20 20 20 20 20 20 20 6 22 22 22 22 4 0 0 0 3 22 22 22 22 20 20 20 20 20 6 5 20 20 20 20 6 22 4 0 0 0 0 3 22 22 22 5 20 20 20 20 20 20 20 20 20 20 20 20 20 6 22 22 22 4 0 0 0 0 0 1 20 20 20 20 20 20 20 20 20 20 20 20 6 22 5 20 20 20 20 20 20 20 20 20 20 20 20 20 20 20 20 20 20 20 6
