42
15
0 0 0 0 0 0 0 23 9 9 9 9 9 9 9 9 9 9 9 9 9 9 9 9 9 9 9 9 9 9 9 9 9 9 9 9 9 9 9 9 9 9 
0 0 0 0 0 0 0 36 27 9 9 9 9 9 9 9 9 9 9 9 9 9 9 9 9 9 9 9 9 9 9 9 9 9 9 9 9 9 9 9 9 9 
0 0 0 0 0 0 0 0 23 9 9 9 9 9 9 9 9 9 9 9 9 9 9 9 9 9 9 9 9 9 9 9 9 9 9 9 9 9 9 9 9 9 
0 0 0 0 0 0 0 0 36 28 27 9 9 9 9 9 9 9 9 9 9 9 9 9 9 9 9 9 9 9 9 9 9 9 9 9 9 9 9 9 9 9 
0 0 0 0 0 0 0 0 12 0 23 9 9 9 9 9 9 9 9 9 9 9 9 9 9 9 9 9 9 9 9 9 9 9 9 9 9 9 9 9 9 9 
0 0 0 0 0 0 0 0 10 0 36 27 9 9 9 9 9 9 9 9 9 9 9 9 9 9 9 9 9 9 9 9 26 28 28 28 28 28 28 28 28 28 
0 0 0 0 0 0 0 0 10 0 0 36 28 28 28 28 28 28 27 9 9 9 9 9 9 9 9 9 26 28 28 28 35 0 0 0 12 0 12 0 0 0 
0 0 0 0 0 0 0 0 11 0 0 0 0 12 12 0 0 0 36 28 28 28 28 28 28 28 28 28 35 0 12 0 0 0 0 0 10 0 10 0 0 0 
0 0 0 0 0 0 0 0 0 0 0 0 0 10 10 0 0 0 0 0 0 12 0 12 0 0 0 0 0 0 10 0 0 0 0 0 10 0 0 0 0 0 
0 0 1 17 14 0 16 0 0 0 14 0 0 10 11 0 0 0 0 0 0 10 0 10 0 0 0 0 0 0 11 0 0 0 0 0 11 0 16 13 0 0 
0 0 30 31 31 31 32 0 0 0 30 32 0 10 0 0 0 0 0 0 0 11 0 10 0 0 0 0 0 0 0 0 17 14 0 0 0 30 31 31 32 0 
0 0 0 0 0 0 0 0 0 0 0 0 0 11 16 0 14 0 0 0 16 0 0 11 0 0 16 14 15 0 0 30 31 31 32 0 0 0 0 0 0 0 
0 0 0 0 0 0 0 0 0 0 0 0 0 0 30 31 32 0 0 34 21 33 14 15 2 34 19 19 33 0 0 0 0 0 0 0 0 0 0 0 0 0 
0 0 0 0 0 0 0 0 0 0 0 0 0 0 0 0 0 0 0 36 27 25 19 19 19 24 9 9 22 0 0 0 0 0 0 0 0 0 0 0 0 0 
0 0 0 0 0 0 0 0 0 0 0 0 0 0 0 0 0 0 0 0 23 9 9 9 9 9 9 9 22 0 0 0 0 0 0 0 0 0 0 0 0 0 
