40
15
9 9 9 9 9 9 9 9 9 9 9 9 9 9 9 9 9 9 9 9 9 9 9 9 9 9 9 9 9 9 9 9 9 9 9 9 9 9 9 9 
26 28 28 28 28 28 27 9 9 9 9 9 9 9 9 9 9 9 9 9 9 9 9 9 9 9 9 9 9 9 9 9 9 9 9 9 9 9 9 9 
22 12 12 0 0 0 36 28 27 9 9 9 9 9 9 9 9 9 9 9 9 9 9 9 9 9 9 9 9 9 9 9 9 9 9 26 28 28 28 27 
22 10 10 0 0 0 0 0 36 28 27 9 9 26 28 28 28 28 28 28 28 28 27 9 9 9 9 9 9 26 28 28 28 28 28 35 0 0 0 23 
22 10 10 0 0 0 0 0 0 0 36 28 28 35 0 0 0 12 0 12 0 0 36 28 28 28 28 28 28 35 0 0 12 0 0 0 0 0 0 23 
22 10 11 0 0 0 0 0 0 0 0 12 12 0 0 0 0 10 0 11 0 0 0 0 0 12 0 0 12 0 0 0 10 0 0 0 0 0 0 23 
22 10 0 0 0 0 0 0 0 0 0 10 10 0 0 0 0 10 0 0 0 0 0 0 0 10 0 0 10 0 0 0 11 0 0 0 0 0 0 23 
22 10 0 0 0 0 0 0 0 0 0 10 10 0 0 0 0 10 0 0 0 0 0 0 0 10 0 0 11 0 16 15 0 0 14 0 0 0 0 23 
22 11 0 0 0 0 0 0 0 0 0 11 10 0 0 0 0 11 0 0 0 0 0 0 0 11 0 17 0 0 30 31 32 0 34 33 0 13 17 23 
22 0 16 0 1 0 15 0 0 0 0 0 10 0 0 0 0 0 0 0 14 0 16 1 0 0 0 29 0 0 0 0 0 0 23 25 20 19 19 24 
25 19 20 19 19 19 20 33 0 0 0 0 11 0 0 0 0 0 0 30 31 31 31 31 31 32 0 0 0 0 0 0 0 0 23 9 9 9 9 9 
9 9 9 9 9 9 9 22 15 0 0 17 0 14 0 0 16 0 0 0 0 0 0 0 0 0 0 0 0 0 0 0 0 0 23 9 9 9 9 9 
9 9 9 9 9 9 9 25 19 21 19 19 19 20 19 21 19 33 0 0 0 0 0 0 0 0 0 0 0 0 0 0 0 0 23 9 9 9 9 9
9 9 9 9 9 9 9 9 9 9 9 9 9 9 9 9 9 25 33 0 0 15 17 0 14 0 0 0 16 0 0 17 15 0 23 9 9 9 9 9
9 9 9 9 9 9 9 9 9 9 9 9 9 9 9 9 9 9 25 19 19 19 19 20 19 19 19 19 21 19 20 19 19 19 24 9 9 9 9 9
